Большое поле
511112111151111211115
131111141111141111131
113111114111411111311
111311111414111113111
111151111111111151111
211113112111211311112
111111311111113111111
141111131111131111141
114112111111111211411
111411111212111114111
511111111161111111115
111411111212111114111
114112111111111211411
141111131111131111141
111111311111113111111
211113112111211311112
111151111111111151111
111311111414111113111
113111114111411111311
131111141111141111131
511112111151111211115
