Классическое поле
511211151112115
131114111411131
113111212111311
211311121113112
111131111131111
141111111111141
112111212111211
511211161112115
112111212111211
141111111111141
111131111131111
211311121113112
113111212111311
131114111411131
511211151112115