Расширенное поле 25x25
5111211121115111211121115
1311111111111111111111131
1131114111311131114111311
1113111113111113111113111
2111311111111111111131112
1111151111121211111511111
1141113111111111113111411
1111111311114111131111111
2111111131111111311111112
1113111113111113111113111
1131111111111111111111311
1111121111121211111211111
5111111411116111141111115
1111121111121211111211111
1131111111111111111111311
1113111113111113111113111
2111111131111111311111112
1111111311114111131111111
1141113111111111113111411
1111151111121211111511111
2111311111111111111131112
1113111113111113111113111
1131111111311131114111311
1311111111111111111111131
5111211121115111211121115
