Максимальное поле 30x30
511211151112115511211151112115
131114111411131131114111411131
113111212111311113111212111311
211311121113112211311121113112
111131111131111111131111131111
141111111111141141111111111141
112111212111211112111212111211
511211161112115511211161112115
112111212111211112111212111211
141111111111141141111111111141
111131111131111111131111131111
211311121113112211311121113112
113111212111311113111212111311
131114111411131131114111411131
511211151112115511211151112115
511211151112115511211151112115
131114111411131131114111411131
113111212111311113111212111311
211311121113112211311121113112
111131111131111111131111131111
141111111111141141111111111141
112111212111211112111212111211
511211161112115511211161112115
112111212111211112111212111211
141111111111141141111111111141
111131111131111111131111131111
211311121113112211311121113112
113111212111311113111212111311
131114111411131131114111411131
511211151112115511211151112115
