Мое поле
222222222222222222222222222222
111111111111111111111111111111
133113331313111331131131333331
111313131313113131131131113111
113313331133113131131131113111
111313111113113131131331113111
111313111113133333133131113111
133113111331131113131131113161
111111111111111111111111111111
555555555555555555555555555555
111111111111111111111111111111
444444444444444444444444444444










