Широкоэкранное WXGA
51111112111111511111121111115
12111411141112121114111411121
11311111111131113111111111311
21131111111311211311111113112
11111121211111111111212111111
14111116111114141111161111141
11111121211111111111212111111
21131111111311211311111113112
11311111111131113111111111311
12111112111112121111121111121
51111411141111611114111411115
12111112111112121111121111121
11311111111131113111111111311
21131111111311211311111113112
11111121211111111111212111111
14111116111114141111161111141
11111121211111111111212111111
21131111111311211311111113112
11311111111131113111111111311
12111411141112121114111411121
51111112111111511111121111115
